GBBBBFGGXFHGHGH
GHXHXTXGGTGGGGG
GGBBBFGXXFHBHXH
XHXHXTXGGTBBBBB
BBBBBFGGXFHXHXH
BHBHBTXXGGBBBBB
TFTFTFGGXFTFTFT
BBBBBGXGGTBHBHB
HXHXHFGXXFBBBBB
BBBBBTXGGTXHXHX
HGHXHFGXXFBBBBG
GGBBBTXGGTXHXHG
HGHBHFGGXFBBBGG